1111111111111
10C10000000C1
1000011110001
1P0011E000C01
1111111111111
