111111111111111111111111111111
1000000000000000100000000000E1
100000000000000C10000000011111
100000001111111111111000011C01
100000000000000000000000011001
100100000000011110000000001001
10C100000011111100C00000001001
111100000000010000000000001001
100000011000010000000000001001
101000000000010000000100001001
101011100000010000001100001001
100011110000000100000100001101
101000000000001111000100000001
1P100000C000001C00000000000001
111111111111111111111111111111
