11111111
11111111
1PC00E11
11111111
11111111
