11111111111111111111111111111111111111
11111111111111111111111111111111111111
1P0C0E11111111111111111111111111111111
11111111111111111111111111111111111111
11111111111111111111111111111111111111
