1111111111
1EP00000C1
1111111111
